11111111111111111111
10000000000000000001
10000011000011111101
10000110C000000E1101
10001100000011111101
100110P0110C11000001
10111111110011111101
10000000110000000001
10000000000000000001
11111111111111111111