111111111111111111
10P000000000000001
10X101110111C11101
100100C10001000101
10010111X1110X0101
10X100C10001000101
100101110111E00101
10000C0X00C0000001
111111111111111111
