11111111111111111111
10000000000000000001
10000011000011111101
10X00110C0C0000E1101
10001100000011111101
100110P0110C11000001
10111111110011111101
10X0C00C110000000001
100000X0000000000011
11111111111111111111