111111111111111111
10P000000000000001
100101110111C11101
100100C10001000101
100101110111000101
100100C10001000101
100101110111E00101
10000C0000C0000001
111111111111111111
